P---##-#----
-#---#-#-#-#
-###-----#-#
##-#-###-#-#
---#-#-#-#-#
##-----#-#-#
-#######-#-#
---------#-#
-###########
-----------E