P--####----
-#--###-#-#
-##-----#-#
###-###-#-#
--#-#-#-#-#
#-----#-#-#
#######-#-#
--------#-#
-##########
----------E